8
AXXXXXXXX
BXXXXXXXX
CXXXXXXXX
DXXXBXXXX
EXXXXXXXX
FXXXXXXXX
GXXXXXXXX
HXXXXXXXX