8
AXXXREBXX
BXXXXXXXX
CXXXXXXXX
DXXXXXXXX
EXXXXXXXX
FXXXXXXXX
GXXXXXXXX
HXXXXXXXX