8
AXXBXXXXC
BXXBXXXXC
CXXBXXXXC
DXXBXXXXC
EXXBXXXXD
FXXBXXXXF
GXXBXXXXE
HXXBXXXXG